11111
1C001
1P001
10E01
11111
