111111111
1PE000C01
111111111
